2211111122
2000000002
2011111102
2000000002
2211111122
0000000000
