1110000111
1010200101
1211111121
1000000001
1111111111
0000000000
