0001100000
0011110000
0111111000
1111111100
0000000000
0000000000
