2211221122
2100000012
2112112112
2000000002
2121111212
0000000000
