2221111222
2000000002
1122222211
2000200002
2121111212
0000000000
